                         /-------\         /-\ 
                         |       |         | |         /-\                 
                         | /---\ |         | |         | |
                         | |   | |         | |         | |
                         | |   | |---------/ \---------/ \--------\
                         | |   |                                  |
                         | |   | /--|--------------|------------| |                                      
                         | |   | |  |              |            | \---
                         | |   \-/  |  |  |     |  |            |    |
                         | \--------|  |  |     |  |            | /---
                         |             |  |     |  |------------/ |
                         \---\ /-------|  |     |                 |
                             | |          |     |  |--------------/
                             \-/-------*#####}#####*##########*
                                       *           *          *
                                       *                      *
                                       *           *          *
                                       *           *##########*
                                       *           *          *
                                       *                      *
                                       *           *          *
                                       *           *##########*
                                       *           *          *
                                       *                      *
                                       *           * S        *
    *#############*                    *           *##########*          *#############*
    *             *                    *           *                     *             *
    *             *                    *           *                     *             *
    *             #####################*####   ####*######################             *
    *             *                                                      *             *
    *                                                                                  *
    *             *                                                      *             *
    *             #####################*####   ####*######################             *
    *             *                       *     *                        *             *
    *             *                       *     *                        *             *
    *#############*                       *     *                        *#############*
                                          *     *
                                *#########*#   #*#########*
                                *                         *
                                *                         *
                                *                         *
                                *                         *
                                *                         *
                                *                         *
                                *#########################*