                                       *#####~#####*##########*
                                       *           *          *
                                       *                @     *
                                       *           *          *
                                       *           *##########*
                                       *           *          *
                                       *                      *
                                       *           *          *
                                       *           *##########*
                                       *           *          *
                                       *                      *
                                       *           *          *
    *#############*                    *           *##########*          *#############*
    *             *                    *           *                     *             *
    *             *                    *           *                     *             *
    *             #####################*####   ####*######################             *
    *             *                                                      *             *
    *                                                                                  *
    *             *                                                      *             *
    *             #####################*####   ####*######################             *
    *             *                       *     *                        *             *
    *             *                       *     *                        *             *
    *#############*                       *     *                        *#############*
                                          *     *
                                *#########*#   #*#########*
                                *                         *
                                *                         *
                                *                         *
                                *                         *
                                *                         *
                                *                         *
                                *#########################*